dzieło=creation
adaptacja=adaptation
agent=agent
akcja odbywa się w=the action takes place in
akt=act
album=album
album o sztuce=art book
antrakt=interval
arcydzieło=masterpiece
artykuł=article
artysta=artist
autoportret=self-portrait
balet=ballet
barwny=colourful
baśń=fairy tale
bazgroły=doodles
bęben=drum
beletrystyka, literatura piękna=fiction
bestseller=bestseller
bohater/bohaterka=hero/heroine
charakteryzator=make-up artist
co grają?=what's on?
czasopismo, magazyn=magazine
dialog=dialogue
dialogi=dialogues
doniesienie, relacja=report
dramat=drama
dramat psychologiczny=psychological drama
dramat wojenny=war drama
dubbing=dubbing
dubbingować=dub
dubingowany=dubbed
dyrygent=conductor
dyrygować=conduct
dzieło sztuki=a piece of art/work of art
dziennikarz=journalist
efekty specjalne=special effects
egzemplarz=copy
fabuła=plot
fantastyczny=fantastic
festiwal=festival
film=film/movie
film akcji=action film/movie
film dokumentalny=documentary
film katastroficzny=disaster movie
film przygodowy=adventure film
film science fiction=science fiction film/sci-fi film
fotograf=photographer
fotografia=photography
galeria=gallery
galeria sztuki=art gallery
gazeta codzienna, dziennik=daily/daily paper/newspaper
gitara basowa=bass guitar
gitarzysta=guitar player/guitarist
główny bohater=main character
główny wokalista=lead vocalist
gospodarz talk show=talk show host
gra aktorska=acting
grać=act
grać=play
grać na instrumencie=play an instrument
grać rolę kogoś=play the part/role of sb
grać, występować w filmie=star in a film
grafika (dziedzina sztuki)=graphic arts
historia miłosna, romans=love story
horror=horror
informować=inform
kanał telewizyjny=tv channel
kariera solowa=solo career
kasa biletowa=box office
kino=cinema
klaskać=clap
komedia=comedy
komedia romantyczna=romantic comedy/ rom-com
komentować=comment
komponować=compose
kompozytor=composer
koncert=concert
koncert=gig
kontrakt płytowy=recording contract
korespondent=correspondent
korespondent wojenny=war correspondent
kręcić film=make a film
kręcić, filmować=shoot
kreskówka=cartoon
kryminał=crime story/detective story
krytyk=critic
kultura=culture
kurtyna=curtain
list do redakcji=letter to the editor
lista przebojów=charts
literatura=literature
literatura faktu=non-fiction
magazyn dla kobiet=woman's magazine
magazyn ilustrowany=glossy magazine
malarz=painter
malować=paint
martwa natura=still life
miejsce gdzie się coś odbywa=venue
miejsce, siedzenie=seat
miesięcznik=monthly
musical=musical
muzeum=museum
muzyk=musician
muzyka=music
muzyka klasyczna=classical music
muzyka ludowa=folk music
muzyka nowoczesna=modern music
na żywo=live
nagłówek prasowy=headline
nagroda=award
nagroda nobla=nobel prize
nowa wersja filmu=remake
nudny=boring
obraz=painting
obraz abstrakcyjny=abstract painting
obraz olejny=oil painting
obsada=cast
obsadzać role=cast
obsadzony w=set in
odcinek=episode
ogólnokrajowa telewizja i radio=national tv and radio
oklaskiwać=applaud
okropny=awful
okropny=dreadful
oparte na książce=based on a book
oparty na prawdziwej historii=based on a true story
opera=opera
operator kamery=cameraman
opowiadać historię=tell the story of
opowiadanie=short story
orkiestra=orchestra
oskar (statuetka)=oscar
osoba znana z mediów=media celebrity
pejzaż=landscape
pełnometrażowy film fabularny=feature film
perkusja=percussion
perspektywa=perspective
pianino=piano
pierwsza strona gazety=the front page
pilot do telewizora=remote control
piosenkarz=singer
pisarz=writer
pisarz piosenek=songwriter
płyta=record
poeta=poet
poezja=poetry
polecać coś komuś=recommended sth to sb
portret=portrait
postać=character
powieść=novel
powieściopisarz=novelist
pracownia=studio
prasa lokalna=local press
prasa ogólnokrajowa=national press
prezenter=presenter
próba=rehearsal
producent=producer
produkcja=production
program=programme
projektant=designer
projektować=design
przebój=hit
przebój=number one hit
przebój filmowy=blockbuster
przedstawienie=performance
przedstawienie=show
przeprowadzać z kimś wywiad=interview sb
przeróbka utworu muzycznego=cover
przesłuchanie do roli=audition
reality show=reality show
reality tv=reality tv
recenzent=reviewer
recenzja=review
redaktor=editor
reporter=reporter
reżyser=director
reżyserować=direct
robić próby=rehearse
robić zdjęcia=take photos/photographs
rola=part
rola główna=leading role/main role
rozczarowujący=disappointing
rozdział=chapter
rozrywka=entertainment
rysować=draw
rysować kredą=draw in chalk
rysować ołówkiem=draw in pencil
rysować węglem=draw in charcoal
rysownik kreskówek=cartoonist
rysunek=drawing
rzeźba=sculpture
rzeźbiarz=sculptor
rzeźbić=sculpt
saksofon=saxophone
sala koncertowa=concert hall
scena=scene
scena=stage
scenariusz=screenplay
ścieżka dźwiękowa=soundtrack
serial=series
serial komediowy=sitcom
skład zespołu=line up
skrzypce=violin
słaby=poor/weak
słynny=well-known
sprzedawca prasy=newsagent
środki masowego przekazu=the media
studio nagrań=recording studio
studio telewizyjne=tv studio
studiować w szkole teatralnej=study at drama school
świetny=excellent
syntetyzator, keyboard=keyboard
szkic=sketch
szkicować=sketch
sztuka=art
sztuka teatralna=play
sztuki plastyczne=visual arts
teatr=theatre
tekst piosenki=lyrics
telenowela=soap opera
teleturniej=game show/quiz show
teleturniej=quiz show
telewizja=tv
telewizja kablowa=cable tv
telewizja satelitarna=satellite tv
thriller=thriller
tło=background
tom=volume
tournee=tour
trąbka=trumpet
transmisja=broadcast
transmisja na żywo=live broadcast
trylogia=trilogy
twórca=creator
tworzyć=create
tygodnik=weekly
ujęcie=shot
ukazanie się singla=release of a single
utwór muzyczny=a piece of music
warty zobaczenia=worth seeing
western=western
wiadomości=the news
wiarygodny=believable
widownia=audience
widz=viewer
wiersz=poem
wokalista=vocalist
wydać, wprowadzić na rynek=release
wystawa=exhibition
występ=performance
występować=perform
występować, grać=appear
wywiad=interview
z napisami=subtitled
zabawny=entertaining
zamieścić coś na stronie internetowej=post sth on a website
zbiór opowiadań=collection of short stories
zdumiewający=amazing
zekranizować książkę=make a book into a film
zespół muzyczny=band/group
znakomity=brilliant
zrecenzować=review